5 7
4 3 3 3 2 2 1
4 3 2 2 2 3 4
4 3 2 3 2 3 4
4 3 2 2 2 3 4
0 2 2 3 3 3 4