5 11
4 3 3 3 2 2 2 2 2 2 1
4 3 2 2 2 3 3 3 3 4 4
0 2 2 4 2 2 2 2 2 2 1
4 3 2 2 2 3 3 3 3 4 4
4 3 3 3 2 2 2 2 2 2 1

4

0 6
2 0 2 2 1 2 1 4 0 4 0 10

0 6
2 0 2 2 3 2 3 4 4 4 4 10

0 6
2 0 2 2 3 2 3 4 2 4 2 10

0 6
2 0 2 2 1 2 1 4 2 4 2 10

# Arknights 1-7
