5 7
4 4 3 3 3 3 1
2 2 2 2 2 2 2
2 3 2 3 2 4 2
2 3 2 4 2 3 2
0 2 2 2 2 2 2