5 7
2 2 2 2 2 2 1
2 4 2 3 2 4 2
2 3 2 4 2 3 2
2 4 2 3 2 4 2
0 2 2 2 2 2 2